111111111111
100001100001
100001100001
100001100001
100000000001
100000000001
100000000001
100000000001
100001100001
100001100001
100001100001
111111111111