111111111111111111
100000000000000001
100000000000000001
100000000000000001
100000000000000001
100001111111100001
100000001100000001
100000001100000001
100000001100000001
100000001100000001
100001111111100001
100000000000000001
100000000000000001
100000000000000001
100000000000000001
111111111111111111