111111111111111111111111
100000000000000000000001
100000000000000110000001
100001100000000110000001
100001100000000000000001
100000000000000000000001
100000000000000000000001
100000000110000000000001
100000000110000000000001
100000000110000111111111
100000000110000111111111
100000000000000000000001
100000000000000000000001
100000000000000000000001
100000000000000000000001
111111111111111111111111