111111111111111111111111111111111111
100001100000000000000000000001000001
100001100000000000000000000001000001
100001100000000000000000000000000001
100001100000000000000000000000000001
100001100000111111111111000000000001
100001100000000000000001000000000001
100001100000000000000001111111111111
100001100000000000000001000000000001
100001100000000000000001000000000001
100001111111111111000001000000000001
100000000000000000000001000000000001
100000000000000000000001000000000001
100000000000000000000001000000000001
100000000000000000000001000000000001
100000000000111111111111000000000001
100000000000000000000000000000000001
100000000000000000000000000000000001
100000000000000000000000000000000001
100000000000000000000000000000000001
111111111111111111111111111111111111