111111111111111111111111
100000000000000000000001
100000000000000000000001
100000000000000000000001
100000000000000000000001
100001100001100001100001
100001100001100001100001
100001100001100001100001
100001100001100001100001
100001100001100001100001
100001100001100001100001
100001100001100001100001
111111111111111111111111