111111111111
100000000001
100000000001
100000000001
100000000001
111100001111
111100001111
100000000001
100000000001
100000000001
100000000001
111111111111